TILE_SIZE: 50
MAP_START
#######################################
#.....................................#
#..........T.................##.......#
#..........###.....................##.#
#......##........###..##.##...###.....#
#......V...##....W....................#
#...............####..................#
#....S.S..####.......SSSS.SSS.SS......#
#######################################

