TILE_SIZE: 50
MAP_START
#######################################
#.....................................#
#..........T.................##.......#
#..........###.....................##.#
#......##........###..##.##...###.....#
#..........##.........................#
#...............####..................#
#.........####................W.......#
#######################################

